10101010
10101010
10110000
00000000
00000110
00101010
10101000
11000100
